


0000000000000000000000000000000000000000000000000000000000000000000000000000000000000000000000000000000000000
0000000000000000000000000000000000000000000000000000000000000000000000000000000000000000000000000000000000000
0000000000000000000000000000000000000000000000000000000000000000000000000000000000000000000000000000000000000
0000000000000000000000000000000000000000000000000000000000000000000000000000000000000000000000000000000000000
0000000000000000000000000000000000000000000000000000000000000000000000000000000000000000000000000000000000000
0000000000000000000000000000000000000000000000000000000000000000000000000000000000000000000000000000000000000
0000000000000000000000000000000000000000000000000000000000000000000000000000000000000000000000000000000000000
0000000000000000000000000000000000000000033333333333333300000333330000000000330000000000000000000000000000000
0000000000000000000000000000000000000000022222922222222200000229220000000000290000000000000000000000000000000
0333333333333333333333330000333000033333344444444444444433333444440330000003440330000000000033330000000000000
0222222222222222222229220000222000022292266666666666666622922666660220000002260220000000000022220000000000000
0444444444444444444444447777444777744444444555555555555444444455553440333004450443333000003344443000000000000
0666666666666966666666668888666888866666666666666966666666666666662660222006660662292000002266662000000000000
1555544455555445555555551111555111155555555555554444445555555555544450444335550004444003304455554300000000000
1666666666666666666644461111666111166666666664466666666666669664666660666226640666666002206664446200000000000
1555555545545555555555551111555111155555555555555555555554454455555550544445550555555304405555555430000000000
1111166666661661116666611111111111111666669666616666666666666666666660966000060666666206606666669620000000000
1111111114411111111441111111111111111111114441111111444445555555555550455555450555544405505544444444444444444
111111111111111111111111111111111111111111111111111116666666666666666066666660666666606606666966666666666666
111111111111111111111111111111111111111111111111111144445555555555550455555450555544405505544444444444444444
1111111111111111111111111111111111111111111111111111166666666666666660666666660666666606606666666666666666666
1111111111111111111111111111111111111111111111111111155555555555555550455555450555544405505555555555555555555
1111111111111111111111111111111111111111111111111111166666666666666660666666660666666606606666666666666666666
1111111111111111111111111111111111111111111111111111155555555555555555555555555555555555555555555555555555555
1111111111111111111111111111111111111111111111111111166666666666666666666666666666666666666666666666666666666
1111111111111111111111111111111111111111111111111111155555555555555555555555555555555555555555555555555555555
1111111111111111111111111111111111111111111111111111166666666666666666666666666666666666666666666666666666666